NO cub/textures/blue.xpm
EA cub/textures/green.xpm
SO cub/textures/red.xpm
WE cub/textures/beige.xpm

C 230,204,166
F 76,57,36

1111111111111111111111111
1000110000100000000000001
1000110000000000111111001
1000110000000S00110001001
1000000000100000000001001
1111111111110000000000001
           10000000000011
		   11100011000011
		   11100000000001
		   10000000000001
1111111111110000000000001
1000000000000000000000001
1111111111111111111111111