NO cub/textures/blue.xpm
EA cub/textures/green.xpm
SO cub/textures/red.xpm
WE cub/textures/beige.xpm

C 230,204,166
F 76,57,36

1111111111111111111111111
1000110000100000000000001
1000110000000000111111001
1000110000000W00110001001
1000000000100000000001001
1111111111111111111111111
