NO bonus/textures/blue.xpm
EA bonus/textures/green.xpm
SO bonus/textures/red.xpm
WE bonus/textures/beige.xpm
DO bonus/textures/door.xpm

C 230,204,166
F 76,57,36

1111111111111111111111111
1000110000100000000000001
1000110000000000111111001
1000110000000W00D10001001
1000000000100000D00001001
1111111111111111111111111